111111111
100011111
111111000
001111100
000011000
