0000000000000000000000000000
0111111111000111111111111110
0100011111111100000000000010
0111111001000101111000111010
0000011001000101111000101010
0111111001111101111111101110
0100011000010001111000000010
0100011000010000000011111110
0100011000010000000010000010
0111111111111111111111111110
0000000000000000000000000000