00000000000
01111111110
01000111110
01111110000
00011111000
00000110000
00000000000